1111111111
1P00000001
1011111111
1011111111
1011011101
1CC00E0001
1111111111