1111111111111111
10010000000000C1
1000000111111001
10P0100101E00001
1111111111111111