1111111111111111
10010000000000C1
1000000011111001
1P0010011E000001
1111111111111111