1111111111
1000000001
10101111C1
1010011101
11110111P1
1100E00011
1111111111