111111111111111111111111111111111111111111111111111111111111
100000000000000000000000001000011100000000000000000000000001
100000000000000000000000000100010100000C00000000000000000001
1000000000000000000C0000001000011100000000000000000000000001
100000001000000000000C00000000000000000000011100000000000001
10000001110000000000000000100000000000000001C100000000000001
100000011100000000000000000000000000000000010100000000000001
100000011100000000C00000001000000000000000000000000000000001
100000011100000000000000001000000000000000000000000000C00001
100001111111000000000000001000000000000000000000000000000001
100001110111000000000000001110000000000000000000000000000001
100000000000000000000000001010000000000000000000000000000001
100000000000000000000000001000011100000000000000000000000001
100000000000000000000000000100010100000C00000000000000000001
1000000000000000000C0000001000011100000000000000000000000001
100000001000000000000C00001000000000000000011100000000000001
100000011100000000000000001000000000000000010100000000000001
100000011100000000000P0000000000000000000001E100000000000001
100000011100000000C00000001000000000000000000000000000000001
100000011100000000000000001000000000000000000000000000C00001
100001111111000000000000001000000000000000000000000000000001
100001110111000000000000001110000000000000000000000000000001
100000000000000000000000001010000000000000000000000000000001
100000000000000000000000001000011100000000000000000000000001
100000000000000000000000000100010100000C00000000000000000001
1000000000000000000C0000001000011100000000000000000000000001
100000001000000000000C00000000000000000000011100000000000001
10000001110000000000000000100000000000000001C100000000000001
100000011100000000000000000000000000000000010100000000000001
100000011100000000C00000001000000000000000000000000000000001
100000011100000000000000001000000000000000000000000000C00001
100001111111000000000000001000000000000000000000000000000001
100001110111000000000000001110000000000000000000000000000001
100000000000000000000000001010000000000000000000000000000001
100000000000000000000000001000011100000000000000000000000001
100000000000000000000000000100010100000C00000000000000000001
1000000000000000000C0000001000011100000000000000000000000001
100000001000000000000C00001000000000000000011100000000000001
10000001110000000000000000100000000000000001C100000000000001
100000011100000000000000000000000000000000010100000000000001
100000011100000000C00000001000000000000000000000000000000001
100000011100000000000000001000000000000000000000000000C00001
100001111111000000000000001000000000000000000000000000000001
100001110111000000000000001110000000000000000000000000000001
100000000000000000000000001010000000000000000000000000000001
111111111111111111111111111111111111111111111111111111111111