1111111111
10111C0001
101C111101
101E011101
1111011111
11P0000001
1111111111
