1111111111
1000000001
1010111111
1010011111
11110111P1
1100E00011
1111111111