111111111111111111111111111111111111111111111111111111111111
100000000000000000000000001000000000000000000000000000000001
1P000000000000000000000000010000E000000C00000000000000000001
100000000000000000000000001000000000000000000000000000000001
100000001000000000000000001000000000000000000000000000000001
100000011100000000000000001000000000000000000000000000000001
100000011100000000000000000000000000000000000000000000000001
100000011100000000000000001000000000000000000000000000000001
100000011100000000000000001000000000000000000000000000000001
100001111111000000000000001000000000000000000000000000000001
100001110111000000000000001110000000000000000000000000000001
100000000000000000000000001010000000000000000000000000000001
111111111111111111111111111111111111111111111111111111111111