1111111111
10000C0001
1010111101
1010011101
1111011101
11P0000E11
1111111111